USE LEFT AND RIGHT KEYS TO MOVE
USE UP KEY TO JUMP
#############################################################################################
#                                                                                           #
############################################################################                #
#%%%%%                                                                                      #
#############################################################################################
% IS THE FINISH LINE
