
THE UNDERSCORES ARE EXPLOSIVE LANDMINES WHICH GIVES 5 DAMAGE
#############################################################################################
#    : : : :   :     :   :     :   :     :   :     :   :  v  :   :  v  :   :  v  :   :      #
#    : : : :   :     :   :     :   :     :   :     :   :     :   :     :   :     :   :      #
#    : : : :   :     :   :     :   :     :   :     :   :     :   :     :   :     :   :      #
#    : : : :   :     :   :     :   :     :   :     :   :     :   :     :   :     :   :      #
#    : : : :   :     :   :     :   :     :   :     :   :     :   :     :   :     :   :      #
#    : : : #####     #####     #####     #####     #####     #####     #####     #####     %#
#    : : :                                                                                  #
#    : : :                                                                                  #
#    : : :                                                                                  #
#    : : n                                                                                  #
#    : :                                                                                    #
#d   : :                                                                                    #
#d   : n                                                                                    #
#d   :                                                                                      #
#d   :                                                                                     x#
#d   n                                                                                     x#
#                                                                                          x#
#    _   _   _   _   _   _   _   _   _   _   _   _   _   _   _   _   _   _   _   _   _   _  #
#############################################################################################
