

################################################################################################################################################################################################
# #                                                                          !   !   !                                                        x                                               %#
# #                                                                                                                                              x                                            %#
# #                                                                            !   !   !                                                            x                                         %#
# #          ###################################################################################################################################################################################
#            #
#            #
#            #
#            #                                  ######################################################################################################
#            #                                 #                  #    x    #   vvv vvv vvv vvv vvv vvv vvv        !!!!!!!!!!          v              #
#            #                                #                                                                                                        #
#            #                               #                    #    x    #      _   _   _   _   _   _           nnnnnnnnnn                           #
#            #                               #                 ########################################################################                 #
#            #                               #                 #!!!!!!!!!!!!!!!!!!!!!!!!!!!!!!!!!!!!!!!!!!!!!!!!!!!!!!!!!!!!!!!!!!!!!!#                 #
#            ################################v                 ########################################################################                 #
#                                                                                                                                                       #
#                                                      nnnnnn                                                                                           #
#                                                                                                                                                       #
#############################################                  #mmmmmmmmmmmmmmmmmmmmmmmmmmmmmmmmmmmmmmmmmmmmmmmmmmmmmmmmmmmmmmmmmmmmmm#                 #
                                             #                 #!!!!!!!!!!!!!!!!!!!!!!!!!!!!!!!!!!!!!!!!!!!!!!!!!!!!!!!!!!!!!!!!!!!!!!#                 #
                                             #                 ########################################################################                 #
                                             #                 !!!!!!!!!!!!!!!!!!!!!!!!!!!!!!!!!!!!!!!!!!!!!!!!!!!!!!!!!!!!!!!!!!!!!!!!                 #
                                              #                                                                                         jjjjjj         #
                                               #                                                                                        dddddd        #
                                                ###############nnnnnnnnnnnnnnnnnnnnnnnnnnnnnnnnnnnnnnnnnnnnnnnnnnnnnnnnnnnnnnnnnnnnnnnn###############
