

########################################################################################
#  #    :   :               :   :             :   :              :   :                %#
#  #    :   :               :   :             :   :              :   :                %#
#  #    :   :               :   :             :   :              :   :                %#
#  #    :   :               :   :             :   :              :   :                %#
#  #    :   :               :   :             :   :              :   :                %#
#       :   :               :   :             :   :              :   :                %#
#       :   :               :   :             :   :              :   :                %#
#       :   :     #!        :   :             :   :              :   :                %#
#       :   :     #!        :   :             :   :              :   :                %#
#       :   :     #!        :   :             :   :              :   :                %#
#       nnnnn     #!        nnnnn             :   :              nnnnn                %#
#                 #!                          :   :                                   %#
#                 #!                          nnnnn                                   %#
#                 #!                                                                  %#
#                 #!                                                                  %#
#                 #!!!!!!!!!!!!!!!!!!!!!!!!!!!!!!!!!!!!!!!!!!!!!!!!!!!!!!!!!!!!!!!!!!!!#
#############nnnnn######################################################################
n MAKE YOU BOUNCE
