

################################################################################################################################################################################################
# # 88888888 888                                                             !   !   !                                                        x                                               %#
# #  888888  888                                                                                                                                 x                                            %#
# #   8888   888                                                               !   !   !                                                            x                                         %#
# #   8888   ###################################################################################################################################################################################
#     8888   #
#     8888   #
#     8888   #
#     8888   #                                  ######################################################################################################
#     8888   #                                 #       :    :  888#    x    #   vvv vvv vvv vvv vvv vvv vvv        !!!!!!!!!!       888v              #
#     8888   #                                #        :    :  888                                                                  888                #
#     8888   #                               #         :    :  888#    x    #      _   _   _   _   _   _           nnnnnnnnnn       888                 #
#     8888   #                               #         :    :  ########################################################################                 #
#     8888   #                               #         :    :  #!!!!!!!!!!!!!!!!!!!!!!!!!!!!!!!!!!!!!!!!!!!!!!!!!!!!!!!!!!!!!!!!!!!!!!#                 #
#     8888   ################################v         :    :  ########################################################################                 #
#     8888   888                          888          :    :  888                                                                  888                 #
#    888888  888                          888          nnnnnn  888                                                                  888                 #
#   88888888 888                          888                  888                                                                  888                 #
#############################################                  ###mmmmmmmmmmmmmmmmmmmmmmmmmmmmmmmmmmmmmmmmmmmmmmmmmmmmmmmmmmmmmmmmmm###                 #
                                             #                 #!!!!!!!!!!!!!!!!!!!!!!!!!!!!!!!!!!!!!!!!!!!!!!!!!!!!!!!!!!!!!!!!!!!!!!#                 #
                                             #                 ########################################################################                 #
                                             #                 888!!!!!!!!!!!!!!!!!!!!!!!!!!!!!!!!!!!!!!!!!!!!!!!!!!!!!!!!!!!!!!!!!!888                 #
                                              #                888                                                                  888 jjjjjj         #
                                               #               888                                                                  888 dddddd        #
                                                ##################nnnnnnnnnnnnnnnnnnnnnnnnnnnnnnnnnnnnnnnnnnnnnnnnnnnnnnnnnnnnnnnnnn##################
