HOLD DOWN KEY TO RUN
A AND D KEYS TO SHOOT
####################################################################################################################################
#                                                                                                                                  #
############################################################################################################################       #
#%%% x                                                                                                                  8888       #
#%%%  x                                                                                                                  88        #
#%%%   x                                                                                                                8888       #
####################################################################################################################################
